1
00000000012000000000
00000000121200000000
00000001212120000000
00000012121212000000
00000121212121200000
00001212121212120000
00012121212121212000
00121212121212121200
01212121212121212120
12121212121212121212
21212121212121212121
02121212121212121210
00212121212121212100
00021212121212121000
00002121212121210000
00000212121212100000
00000021212121000000
00000002121210000000
00000000212100000000
00000000021000000000
2
00000000011000000000
00000000111100000000
00000001111110000000
00000011111111000000
00000111111111100000
00001EE111111EE10000
000111EE1111EE111000
0011111EE11EE1111100
01111111111111111110
111111111UU111111111
111111111UU111111111
01111111111111111110
0011111EE11EE1111100
000111EE1111EE111000
00001EE111111EE10000
00000111111111100000
00000011111111000000
00000001111110000000
00000000111100000000
00000000011000000000
