3
12121212000012121212
21212121000021212121
12EEEE12000012EEEE12
21EUUE21000021EUUE21
12EUUE12000012EUUE12
21EEEE21000021EEEE21
12121212000012121212
21212121000021212121
00000000000000000000
00000000000000000000
12121212000012121212
21212121000021212121
12EEEE12000012EEEE12
21EUUE21000021EUUE21
12EUUE12000012EUUE12
21EEEE21000021EEEE21
12121212000012121212
21212121000021212121
00000000000000000000
00000000000000000000
3
22222222000022222222
21111112000021111112
21EEEE12000021EEEE12
21EUUE12000021EUUE12
21EUUE12000021EUUE12
21EEEE12000021EEEE12
21111112000021111112
22222222000022222222
00000000000000000000
00000000000000000000
22222222000022222222
21111112000021111112
21EEEE12000021EEEE12
21EUUE12000021EUUE12
21EUUE12000021EUUE12
21EEEE12000021EEEE12
21111112000021111112
22222222000022222222
00000000000000000000
00000000000000000000