2
00000000000000000000
00000000000000000000
00000000000000000000
00000000000000000000
00000000000000000000
00001200000000120000
00012120000001212000
00121212000012121200
01212121200121212120
12121212121212121212
21212121212121212121
02121212100212121210
00212121000021212100
00021210000002121000
00002100000000210000
00000000000000000000
00000000000000000000
00000000000000000000
00000000000000000000
00000000000000000000
2
00000000000000000000
00000000000000000000
00000000000000000000
00000000000000000000
00000000000000000000
00002200000000220000
00021120000002112000
00211112000021111200
0211EE11200211EE1120
211EEEE112211EEEE112
211EEEE112211EEEE112
0211EE11200211EE1120
00211112000021111200
00021120000002112000
00002200000000220000
00000000000000000000
00000000000000000000
00000000000000000000
00000000000000000000
00000000000000000000